###  ###  
#@#  # # 
# #### #
#      #
# #### #
# #  # #  
# #  #.#
###  ###