         #####
         #   #
         #   #
        #    #
########     #
#            #
#         # ##
#         # #
#   $     # #
#    #    # #
#   #     # #
#         # #
#         # #
# @  ###### ####
#              #
###########    #
###     ########
