         #####
         #   #
         #   #
        #    #
########     #
#            #
# $       # ##
#         # #
#         # #
#         # #
#         # #
#         # #
#         # #
# @  ###### ####
#              #
###########    #
###     ########
