         #####
         #   #
         #   #
        #    #
########     #
#            #
#         # ##
#         # #
#         # #
#   @     # #
#         # #
#         # #
#         # #
#    ###### ####
#             ##
########### $ ##
###     ###   ##
          ######
