         #####
         #   #
         #   #
        #    #
###########  #
#       . #  #
# $       # ##
#         # #
#         # #
#         # #
#         # #
#         # #
#         # #
# @  ###### ####
#              #
###########    #
###     ########
