         #####
         #   #
         # $ #
        #  $ #
########   $ #
#            #
#   $   $ # ##
#         # #
#         # #
#    $    # #
#   $$$   # #
#    $    # #
#         # #
# @  ###### ####
#            $ #
###########    #
###     ########
