         #####
         #   #
         # $ #
        #  $ #
########   $ #
#   $        #
#  $$   $ # ##
#         # #
#         # #
#    $    # #
#   $$$   # #
#    $    # #
#         # #
# @  ###### ####
#            $ #
###########  $ #
###     ########
