##########################
#                        #
#                        #
#                        #
#                        #
#                        #
#                        #
#                        #
#                        #
#          ###           #
#          # #           #
#          ###           #
#                        #
#                        #
#                        #
#                        #
#                        #
#     @                  #
#                        #
#                        #
#                        #
#                        #
#                        #
#                        #
##########################
