##########################
#                        #
#                        #
#                        #
#                        #
#                        #
#        $     $         #
#        $$   $$         #
#         $$ $$          #
#          $$$           #
#           $            #
#          $$$           #
#         $$ $$          #
#        $$   $$         #
#        $     $         #
#                        #
#                        #
#                        #
#                        #
#                        #
#                        #
#                        #
#                        #
#                        #
##########################
