##########################
#                        #
#                        #
#                        #
#                        #
#                        #
#                        #
#                        #
#                        #
#           ##           #
#          ###           #
#          ##            #
#                        #
#                        #
#                        #
#                        #
#                        #
#     @                  #
#                        #
#                        #
#                        #
#                        #
#                        #
#                        #
##########################
