         #####
         #   #
         #   #
        #    #
########     #
#            #
#         # ##
#         # #
#         # #
#    $    # #
#   $$$   # #
#   $ $   # #
# @       # #
#    ###### ####
#              #
###########    #
###     ########
