         #####
         #   #
         #   #
        #    #
###########  #
#         #  #
#         # ##
#         # #
#         # #
#         # #
#       $ # #
#        $# #
#       $   #
# @  ###### ####
#              #
###########    #
###     ########
