################
#              #
#              #
#      $       #
#     $        #
#     $ $      #
#      $$      #
#              #
#   @          #
#              #
################
