##########
#        #
#   .    #
#  .+.   #
#   .    #
#        #
##########
