######    ###
# @  ###### ####
#      $   $   #
###########    #
###     ########
