#######
#@ .  #
#     #
#  $  #
#     #
#######
