###########
#    .    #
#        @#
#         #
#         #
#         #
#    $    #
#         #
#         #
###########
