      ###
      #.#
  ##### #####
 ##         ##
##  # # # #  ##
#  ##     ##  #
# ##  # #  ## #
#     $@      #
####  ###  ####
   #### ####
