      ###
      # #
  #####.#####
 ##         ##
##  # # # #  ##
#  ##     ##  #
# ##  # #  ## #
#      @$     #
####  ###  ####
   #### ####
