#######
#@    #
#. $  #
#     #
#######
