###########
#         #
# .    $ @#
#         #
###########
