#########
#       #
#  $  . #
#  $  . #
#  $  . #
#       #
#      @#
#########
