#######
#    @#
#$    #
# #   #
#.#   #
#######
