######   #####
# @   ###    #
#      $     #
#.    ###    #
######   #####
