########
#   @  #
# $ $ $#
# . . .#    
########
