###############
####  ##  #####
###        ####
###  ####  ####
#### #### #####
#  $$$  # #####
#  ...@ # #####
######### #####
#     ##  #  ##
#     ##      #
# ## ####  #  #
# #  #  #### ##
#       ####  #
###  #        #
######  ###  ##
###############

