#######
##    #
####  #
##    #
#######