###############
#      $      #
#    #####    #
# @ .#   #    #
######   ######