########
#.#    #
#.#  $ #
#    $ #
#  @   #
########