#################
#@              #
#       $      .#
#              .#
#       $       #
#               #
#################