       #######
       #     #
       # $$$ #
       #     #
     #### # ####
######    .    ######
#   #    ...    #   #
#   $  ##...##  $   #
#   #    ...    #   #
######    .    ######
     #### # ####
       #     #
       # $$$ #
       #     #
    ######@######
    #   #   #   #
    #   $ $ $   #
    #####   #####
        #####