#################
#@             .#
#               #
#               #
#               #
#               #
#################