##################################################
#                                                #
#  ######################################## ##$$ #
#                                           #    #
#  ###################### ################# ##$$ #
#                         # $ $ $ $ $ $ $ $ #    #
##### ################### #                 ##$$ #
#   # #                   ###               #    #
# $$# # ################################### ##$$ #
#   # #                                  ## #    #
# $$# # #### # #########################    ##$$ #
#   # #        #.......................#  # #    #
# $$# # #  #   #.....................  #  # ##$$ #
#   # # #  # . ......                  #  # #    #
# $$# # #  # # #.....................  #  # ##$$ #
#   # # #  # # #.......................#  # #    #
# $$# # #  # # #.......................#  # ##$$ #
#   # # #  # # #########################  # #    #
# $$# # # ##############################  # ##$$ #
#   # # # #   #   ######################  # #    #
# $$# # #                                 # # $$ #
#   # # # ###############################    # # #
# $$# #                                   #    # #
#   # ######################################## # #
# $$  # $ $ $ $ $ $ $ $ $ $ $ $ $ $ $ $ $ $ $  # #
#  #  #                                        # #
#  # ######################################### # #
#  # #                                         # #
#  #                                         #   #
#  #  ######################################## # #
#  #                                             #
## #  ######################################## ###
## ### $@$ $ $ $ $ $ $ $ $ $ $ $ $ $ $ $ $ $ $ $ #
##     $ $ $ $ $ $ $ $ $ $ $ $ $ $ $ $ $ $ $ $ $ #
##                                               #
##################################################