#######
##@   #
####  #
##    #
#######