         #####
         #   #
         #   #
        #    #
########     #
#.           #
########### ##
          # #
          # #
          # #
          # #
#####     # #
#@  #     # #
#   ####### ####
#              #
########### $  #
###     ########