         #####
         #   #
         #   #
        #    #
########     #
#.           #
########### ##
          # #
          # #
          # #
          # #
#####     # #
#@  #     # #
#   ####### ####
#          $   #
###########    #
###     ########