         #####
         #   #
         #   #
         #   #
##########   #
#.           #
########### ##
          # #
          # #
          # #
          # #
#####     # #
#@  #     # #
#   ####### ####
#           $  #
###########    #
###     ########