         #####
         #   #
         #   #
        #    #
########     #
#.           #
########### ##
          # #
          # #
          # #
          # #
######    # #
#    #    # #
# @  ###### ####
#          $   #
###########    #
###     ########
