###  ###  
#@#  #.# 
# #### #
#      #
# #### #
# #  # #  
# #  # #
###  ###