################        ################
#@     $      .#        #      $      .#
#      $      .#        #      $      .#
#      $      .#        #      $      .#
#      $      .#        #      $      .#
#      $      .#        #      $      .#
#      $      .#        #      $      .#
#      $      .#        #      $      .#
#      $      .#        #      $      .#
#      $      .#        #      $      .#
#      $      .#        #      $      .#
#      $      .#        #      $      .#
#      $      .#        #      $      .#
#      $      .#        #      $      .#
#      $      .#        #      $      .#
#      $      .#        #      $      .#
#      $      .#        #      $      .#
#      $      .#########               #
#                                      #
########################################