###  ###
#@#  # #
# #### #
#      #
# #### #
# #  # #
# #  # #
###  ###
