##### #####
#   ###   #
#    $  + #
#   ###   #
##### #####
