############################################################################################################################
#                                                                                                                          #
#                                                                                                                          #
#@                                                                                                                        .#
#                                                                                                                          #
#                                                                                                                          #
############################################################################################################################