############################# 
# # @     #         #     # # 
# ##### # # ##### ### # # # # 
#     # # # #   #     # # # # 
##### # # ### # ### ### # # # 
# $.#   #     #   # #   # # # 
# ############### ### ### # # 
#               #     #     # 
############# ### ######### # 
#       #   # #   #     #   # 
# ##### # # # # ### ### # ### 
# #  #  # # # #   #   # #   # 
# #       #     $ #         # 
#############################