#######
#@    #
#  $  #
#     #
#  .  #
#######
