###########
#         #
#    $   @#
#         #
#         #
#         #
#         #
#    .    #
#         #
###########
