###########
#         #
#@ $     .#
#         #
###########
