#####
#   #
# $ #
# $ #
# $ #
#   #
#####   
