#####
#   #
# . #
# . #
# . #
#   #
#####   
