#############
#    @      #
#    $$$    #
#           #
#   ...     #
#############
