#######
#    @#
#     #
# # $ #
#.#   #
#######
