#######
#    @#
#     #
#     ####
#  $  $..#
##########
