#######
#     #
#     #
#     ####
#  $ @$..#
##########
