#######
#    @#
#$    #
#.# $ #
#.#   #
#######
