#######
#     #####
#$ .  $  @#
#.    #####
#     #
#######
