#################
#               #
#       . . .   #
#               #
#   #       .   #
# ########      #
#  $ @ $ $      #
# ### ## #      #
#   #$## #      #
#   #           #
#               #
#               #
#               #
#               #
#################
