   ######
  ##    #
###   @ #
#   $## #
# $   # #
# ##  # #
# ## ## #
# $  #  #
# #  $  #
######..#
     #..#
     ####
