####
#  ####################
#    #                #
#.#  #       $#$#$#$$ #
### ##  ## # $ $ $  # #
# # ##  #  # # $ # $  #
#   ##  ## # $ # $ #$ #
#    #     #          #
## #$#  ## # ##########
 # # ##  # ###      #
 # #     #     $   @#
 # # # #.#    ## $ ##
 # # # # # ...#  #..#
 #     ### .#.#  ##.#
 # ### #   ...  ##..#
 #  #  # *#  #      #
 # ##$ #. .         #
 #     ##############
 #  ####
 ####
