     ################
    #####  #######  #
   ######      ##   #
  #####   $$$# $    #
 ###  #  $ # $   ####
###    @ #    ####
# .. $ #   ####
# ..$#$  ###
#..#.  ###
#..  ###
######
