      ######
 ######    ###
##  .        #
#  ##  $ # $ #
## .  $# $$# #
#  # # $$#   #
#  ..#     ###
#  .########
## .+#
 #####
