########        #####
#   #  #        #   #
#      ########## $ ##
#####              # #
    #        #$   $  #
    #  ##..### ##$#$ #
    #  #.....# #     #
    #  ##...##   ##$ #
 ####   #      #$   #########
 #  # #        $ $#$#..#  # ###
 #@      #####      # .#.   . #
 #### #  #   ########..## # # #
    # #### $            # #   #
    #  $  $#$ $  #          ####
    #  # $ $  #      ######    #
    #              ###    # ## #
    ################      #    #
                          ######
