##########
#...     #
#. .#$ $ ##
#. .$ $#$ #
#...# $   #
##    # $ #
 ##  $$$# ##
  ##      @#
   #########
