  ####               ####
  #  ######          #  ######
  #       ############       #
  #  ## #               # ## #
  #   #   $ $ ######  $ # ## #
  ##  # $######..  # $#$# ## #
  #  ##$ ##...#+.  ## $ # ## #
  #     ## ...###  #    # ## #
  # #  ##  ..###  ##$ # # ## #
  # ####   .###    # $  #    #
 ## #..    ###    ## #  ######
##. ##.    ##    ##   $     #
#.   #### ##    ##   $#$ $  #
#.        #    ## $ # $ $#$ #
##.#####      ##  #$   # $  #
 ###   ####  ##             #
          ###################
