 #######
 #     #
 #  #  ############
 # ###  $      $  #
##  #   # $#$ $#$ #
#....      $ $  $ #
#...#### $#$ # $# #
#+..#  #          #
##..#  ############
 ####
