 ################
 #      #       #
 #$  $ ###$# $# #
 #  ##  #  ## $@#
## ## $        ##
#. .#  $ #######
#.   $ ###
##.   ##
 ##..##
  #..#
  ####
