####
#  #       #####
# ##########   #
###.#  #   ### #
  #.# $#$# # ###
  #.#    # $ #
  #.##$# # # #
  #        # #
  #@   ###   #
  #        ###
  #.##$#$# #
  #.#  # # ##
  #.# $#  $ #
###.#    #  #
# ########  ###
#  #     #### #
####       #  #
           ####
