   #####
   #   #
   # # ##########
#### #  #   #   #
#       # $   $ #####
# ## #$ #   #   #   #
# $  #  ## ## $   $ #
# ## #####  #   #   #
# $   #  #  ###### ##
### $    @  ...# # #
  #   #     ...# # #
  #####  ###...# # ###
      #### ##### #   #
                 # $ #
                 #   #
                 #####
