 ###########
##         ##
#  $     $  #
# $# #.# #$ #
#    #*#    #####
#  ###.###  #   #
#  .*.@.*.      #
#  ###.###  #   #
#    #*#    #####
# $# #.# #$ #
#  $     $  #
##         ##
 ###########
