         ####
         #  #
      ####$ ####
      #        #
      # ##.### #
      # ###### #####
      #  +$ ## #   #
  ######### #. $   #
  #   ##.## ## #   #
### #       ## #####
# $   # $##### #
# ###.#  #   $.#
#   ######    ##
#   $.     ####
############
