     #     #
    #########
     #     #
   ###     ###
 # # #     # # #
###### #.# ######
 #    $. .$    #
 #   # #$# #   #
 #   . $@$ .   #
 #   # #$# #   #
 #    $. .$    #
###### #.# ######
 # # #     # # #
   ###     ###
     #     #
    #########
     #     #
