########
#.#    #
#.# ## ####
#.# $   $ #
#.# # # # #
#.# # # # #
#   # #   #
# $ $ # $ #
#   #@  ###
#########
