####################
#+.... #   #   #   #
#...   $   $   $   #
#...   #   #   #   #
#.   ############$##
#.  ##  #  #  ##   #
##$##   $ $#$      #
#   #   #  $  ##   #
#   #####     ######
#   #   ###$###
##$## $ ##   #
 # ##   ##   #
 # #  ####   #
 #     #######
 # #     #
 # ##$## #
 #    #  #
 #### # ##
    #   #
    #####
