    #######
    #   #@##
    #   $  #
    #  #$  ##
  ###   $   #
###.#  ## $ #
#...# $$    #
#...  $     #
#...  #  $$##
## # $#    #
 # #      ##
 # # ######
 #   #
 #####
