          #####
    #######...#
    #        .#
    #        .#
  ###  $  #  ##
  #   $#$   ##
  #    #    #
  # $#$#$#$ #
  #    #    #
 ##   $#$   #
##  #  $  ###
#.        #
#.     @  #
#...#######
#####
