           ####
           #  #
           #  #
           #  #
#######   ##$$##   #######
#     #####.  .#####     #
#         $ +. $         #
#         $ .. $         #
#     #####.  .#####     #
#######   ##$$##   #######
           #  #
           #  #
           #  #
           ####
