 ###########
##      #  #
#  #.   #  #
#      .#  #
##$$##@##$$##
 #  #.      #
 #  #   .#  #
 #  #      ##
 ###########
