     #####
 #####   #
 #    $$ ######
 # ###    #   #
 #  $ $ $ ##$ #
 #$ # $ #     #
 # $#   #  ####
 #  $ #$# ##
 # #      ##
## #####   #
#   #.#@   ##
#    .##   .#
##   .......#
 ####.#######
    ###
