                #####
                #   #
  ############### # #
 ##               # #
 #    #### #  #...  #
 #  #$#  $ #  ###.# #
 #  #   $       ### #
 ##   $ $#$#  #     #
###   # @#   ## #####
#.  # #$##$     #
#..      $  #####
#...# $    ##
##### # ####
    #   #
    #####
