  ####
### @#####
#  $$$   #
# **.**  #
##     ###
# .***. #
#       #
#########
1
