       ###
    ####.####
    #... ...#
    #.#. .#.#
    # #.#.# #
    # # # # #
  ### # # # ###
  #   # # #   #
### #   #   # ###
# $ $ $ $ $ $ $ #
#  $#$#$#$#$#$  #
#       @       #
#################
