######
#    ###
# ##   #
#      #
# ## $ ####
#.# $ $ #.#
#.#  $  #.#
#.# $ $ #.#
#.#  $  #.#
#.# $ $ #.#
#### $ ## #
   # @    #
   #   ## #
   ###    #
     ######
