    #####
   ##   #
  ##  $ #
 ##  $#$#
##  $ . #####
#  $ ...    #
# $#..@..#$ #
#    ... $  #
##### . $  ##
    #$#$  ##
    # $  ##
    #   ##
    #####
