       #######
  ######     #
  #...## # # #
  #.         #
  #.       ###
##### #$##   #
#   #    # $ #
# $ $ $$ $ $ #
# $ #    #   #
#   ##$# #####
###  # #  .#
#         .#
# #@# ##...#
#     ######
#######
