     #####
     #   #
###### # ########
#         #    .#
# $   #        .#
# $   #   #    .#
# $ ####### #####
# $ #    #    .#
# $   @  #    .#
# $ #    #    .#
# $ ## #### #####
# $ #   ###    .#
# $ #          .#
#   #   ###    .#
######### #######
