#####                  #####
#   ##                ##   #
# $  ##              ##  $ #
#  $  ##   ######   ##  $  #
##  $  ##  #    #  ##  $  ##
 ##  $  #### ## ####  $  ##
  ##  $   #  ..  #   $  ##
   ##       ....       ##
    #  ####..@ ..####  #
    #  ####..  ..####  #
   ##       ....       ##
  ##  $   #  ..  #   $  ##
 ##  $  #### ## ####  $  ##
##  $  ##  #    #  ##  $  ##
#  $  ##   ######   ##  $  #
# $  ##              ##  $ #
#   ##                ##   #
#####                  #####
