           #####
           #   #
       ##### # #
       #   $ # #
       # ### # #
       # $     #
       # # ### #
######## #$$   #
#...  #   $  ###
#...      ## ###
#...  #    $   #
########$# ### #
       # $ # # #
       # # ### #
       # $     #
       # ### ###
       #  @  #
       #######
