     ###########
     #         #
  #### # ##### #
  #..     ...# #
  #.### ####.# #
  # #      # # #
  #   $$$$   # #
### # $    # # #
#   # $@$$ #   #
# # # $  $ # ###
# #   $$$$   #
# # #      # #
# #.### ####.#
# #..     ...#
# #### # #####
#        #
##########
