####     ####
#  #     #  #
# ######### #
###       ###
  #   $   #
 ## .   . ##
 # .$#$#$. #
 #  .   .  #
 # *#$#$#* #
 #    @    #
 ###########
  #       #
  #########
   #     #
   #######
    #   #
    #####
     # #
     ###
