       #####
   ##### @ #####
####  ## # ##  ####
#        #        #
# ##$# # # # #$## #
#    # # # # #    #
### $# # # # #$ ###
  #     ...     #
  ## ###.#.### ##
   #    ...    #
   ### # # # ###
   #     #     #
   # ### # ### #
   # $ $   $ $ #
   #   #   #   #
   #############
