  ################
  #              #
  # # ## ##$#### #
  # #     $      #
### #$### # ##$# #
#      .....   # #
# ### #.###.#$## ###
#   $  .....       #
# # ### # ### # ##@#
# #     #  $       #
# #$# # # ### ## ###
# $ #$#       $  #
# # # #$### ######
#           #
#############
