##############
#..        ..#
#.# ##  ## #.#
#  . $  $ .  #
# # ## $## # #
# #$##  ##$# #
#     $ $ $  #
#  $ $ $     #
# #$##  ##$# #
# # ##$ ## # #
#  + $  $ .  #
#.# ##  ## #.#
#..        ..#
##############
