  #######
  #.....#
  #     #
 ## $#$ ##
##  $ $  ##
#   $ #   #
#   #@#   #
#   # $   #
##  $ $  ##
 ## $#$ ##
  #     #
  #.....#
  #######
