################
#      ##      #
#    $ ## $    #
#  $ $ ## $ $  #
# $##########$ #
#      ##      #
# $ $      $ $ #
###### ## ######
#  ### ## ###  #
#       @      #
#      ##      #
#  ##########  #
#    ..##..    #
#    ..##..    #
#    ..##..    #
################
