  ##########
  #        #
  # ## ##  #
###        #
#   $#.#$# #
# $# .+.   ##
#   $#.#$   #
#    .*. #$ #
#  #$#.#$   #
##        ###
 #  ## ## #
 #        #
 ##########
