 #######
 #     #
 #  $  #
##  #  ##
#  .$.  #
# #$+$# #
#  .$.  #
## . . ##
 # # # #
 # $ $ #
 #     #
 #######
