  #####
###   ########
#            #
#     ###    #
# ##$##.#$## #
# ## #..# ## #
# $  #..#  $ #
# ## #  # ## #
# $   @    $ #
# ## #  # ## #
# $  #..#  $ #
# ## #..# ## #
# ##$#.##$## #
#    ###     #
#            #
########   ###
       #####
