################
#.#            #
#.#$### ###$## #
#.#   # $      #
#.# # # # #### #
#.# # # #      #
#         # #$##
#@### # # # $  #
#       # #$## #
#.# # # # $  # #
#.# # # #$## # #
#.# # #$# ## # #
#.#            #
################
