############################
#      #     #  ###  #     #
#   $ $      #  ##         #
# $#####  #     #    #  #  #
#      #  #  #      ##  #  #
#   $  #  #  #      ##  #  #
#####$ #  #     #    #  #  #
#  $   #     #  ##         #
#     @#     #  ###  #     #
# ####################### ##
#      #      #     #  ##  #
###### #      #         #  #
  #### #  #      #  #   #  #
  #..  #     ##  #  #      #
  #..        ##     #      #
  #..  #  #         #  #   #
  ######      #  #     #   #
       #      #  #  #  ##  #
       #####################
