 #########
 #       # ######
 #  $ ## ###    ####
## ##    #.# ##    #
#  $  ## #.#    ## ##
# ##     #.   #  $  #
#  $  ## #.@     ## #
# ##      .# ##  $  #
#  $  #   .#     ## #
## ##    #.# ##  $  #
 #    ## #.#    ## ##
 ####    ### ## $  #
    ###### #       #
           #########
