      #############
      #   #   #   #
      #   $   $   #
      #   #   #   #
########$#######$##
#...  #   #   #   #
#...  $   $ @ #   #
#...  #   #   #   #
################$##
      #   #   #   #
      #   $   $   #
      #   #   #   #
      #############
