###################
#                 #
# # ##$##$##$## # #
#     $  @  $     #
# # ##$##$##$## # #
#     .## ##.     #
##### . . . . #####
    # .## ##. #
    #         #
    ###########
