   #####
   #   #
   # $$####
   #  $ $ #
   # $#   #
####  ##$ ######
#@    ##     ..#
##           ..#
 ########### ..#
          ######
