 ####
##  ####
#   $  #
# $$#@ #
# $ ## #
#    #.#
## $ ..#
 ##  ..#
  ######
