###########
#..#     @#
#..# $ $ ##
#     $ ##
#  # $ ##
#  #  ##
#    ##
######
