   ####
   #  #
#### $####
#@    $  #
##    #. #
 #  $## .#####
 ##   #.     #
  #          #
  ##    ###  #
   ###### ####
