        ####
      ###  ##
     ##   $ #
  ####   $  #
  #   $  #$ ##
### $ #$##   #
# @ #       ##
# # ## #    #
#   ..    ###
###.... ###
  #######
