  ###########
  #   @  #  #
  #   #  #  #######
  #   ##     #  . #
  # $##   #    ...#
###$  #  ###    . #
#   $     #  ######
#   ##        #
# $##         #
#   #  ########
#   $  #
###    #
  ######
