  ####
  #  ####
 ##@ $  #
 # *.*  #
## * * ##
#  * * #
#  *** #
##     #
 ####  #
    ####
1
