##########
#     #  ###  ####
#     .    ####  #
# # #####$   $   ####
# # #. .#   ##  $#  #
# # #. .###$###  . $##
# # ##  ##    $  $   #
# #  #  #.  ### $#$ ##
#   ##  ## ##.#  $   #
# .  #  #.  # #### $ ##
#. . #  ##     $ $ # @#
# . ##  $   #   $  $ ##
#. . #   $###$ #######
# .  ###      ##
###  ..########
  ######
