###   #####
# #####   #
#    #  #@#
#  $     ##
##$ #.  ##
#  $## .#
##.  # ##
 ##    #
  ######
