            #######
      ####  #  #  #######
      #  ####  #        #
########  $    # #   #  #
#     .# $$$##$#.##### ##
#           #  # #   #  #
#  ###.# ####$     .    #
#### ###  . $   ####  $##
      #@  #    ##  ##  #
      ###... ###    ####
        ######
