 ####
##  ###########
#             #
# .# #    ##  #
#.@.    #  #. #
# .#  ###     #
#      $ $    #
#### #$ $ $####
   #       #
   #########
