    ####                ####
#####  ##################  #
#                          #
#   ## ##   # # # # # #    #
## ##   ##              #  #
 # #  @  ## # # #  #  #    #
 # #  #   # . .         #  #
 # #    # # # ## ##### #   #
 # ##..   # .  # #   # #   #
 #  #..#### #    # * #   # #
 # $####  #   ####.#.# #   #
 #      $ #####    . # # # #
 #   $  #     $  #   #     #
 # $### $   $ #  #####  #  #
 #    #$### #  $ #   #######
 #### $  #  # ####
    ##         #
     ###########
