############
#          #
#          #
# # ##  ## #
# # ##  ## #
#       ## ##
#   ##  ##  #
###  ##     #
 #  $ ##  # ###
 ##  $ ##   ..#
  ##  $ ##  ..#
   ##  $ ## ..#
    ##  $ #####
     ##  $    #
      ##   # @#
       ########
