############
#   #   #  ######
#             # #
# # ##  # ###   #
# # ###   ..#$  #
#    ###  .+# $ #
#     #######$  #
#  #        $  ##
#  #        ####
#############
