####
#  ########
#      $  ##
#  #####   ##
#    #  $   ##
# @  #  # $  #
# #  #  ##   #
#    #  ###  #
#         #$ #
#### # #    ##
   # .     ##
   #. ..####
   ######
