  #####
  #   ##
### #  ####
#         #
#   #  ## #
# $###$ #.#
#   #   ..#
#   $ # #.#
##   ##$  #
 #@#### # #
 ###  #   #
      #####
