#################
#               #
# $            .#
#  $            #
#               #
#################