#################
#@              #
# $            .#
#  $            #
#               #
#################
