#######
#$#   #
#   $ #
#@ $  #
#######