#######
#     #
#@ $ .#
#     #
#######
