#######
#. #.#
#  $  #
#$   @#
#######