#####  ###
# @ #  #.#
# $ #  ###
#   #### #
#        #
##########
