###  ###
#@#  #.#
#$#  # #
# #### #
#      #
########
