################
#$            .#
############   #
#@             #
################
