################
#             .#
############  $#
#@            ##
################
