################
#             .#
############  $#
#@            $#
################
