################
#             .#
############$$$#
#@             #
################
